#LEVEL 1
WWWWWWWWWWWW
W          W
W  R    O  W
W          W
W   WWWW   W
W   W  W   W
W   W  W   W
W          W
W  O    R  W
WWWWWWWWWWWW
#ENDLEVEL 1

#LEVEL 2
WWWWWWWWWWWW
W R O R O RW
W O        W
W R  WWWW  W
W O  W  W  W
W R  W  W  W
W O  W WW  W
W R        W
W O R O R OW
WWWWWWWWWWWW
#ENDLEVEL 2

#LEVEL 3
WWWWWWWWWWWW
W   W    W W
W W W WW W W
W W   WW   W
W WWWW  WWWW
W          W
W WWWW  WWWW
W W   WW   W
W W W WW W W
W   W    W W
WWWWWWWWWWWW
#ENDLEVEL 3

#LEVEL 4
WWWWWWWWWWWW
W   O      W
W OROR W WWW
W   O  W   W
WWW WW W R W
W R    W O W
W O WWWW R W
W R W    O W
W O WWW WWWW
W   R      W
WWWWWWWWWWWW
#ENDLEVEL 4

#LEVEL 5
WWWWWWWWWWWW
W W O W OWRW
W W W W W WW
W       O  W
W W W WW W W
W O W      W
W W    W W W
W   O   O  W
W W W W W WW
WRW O W OWRW
WWWWWWWWWWWW
#ENDLEVEL 5

#LEVEL 6
WWWWWWWWWWWW
W  RO W  R W
W R  R  R OW
W      W W W
W R W O    W
W  W R R W W
W R   O  W W
W   WWW W  W
W R  R  R OW
WO R       W
WWWWWWWWWWWW
#ENDLEVEL 6

#LEVEL 7
WWWWWWWWWWWW
W OR WOROWOW
W W   W   WW
W R O R O RW
W    W   W W
W O R O R OW
W          W
W R O R O RW
W    W     W
WO ROWO WR W
WWWWWWWWWWWW
#ENDLEVEL 7

#LEVEL 8
WWWWWWWWWWWW
W O      R W
W R W  W W O
W O W  W   R
W R W RW W O
W  W O  W RW 
W R W RW W O
W O    W   R
W R W WW W O
W O      R W
WWWWWWWWWWWW
#ENDLEVEL 8

#LEVEL 9
WWWWWWWWWWWW
W RWOWOWOWRW
W   W W W WW
W ROR O   RW
W  W     W W
W O     O OW
W W WWW W  W
W R   O   RW
W W W W W WW
WRWOWOWOWRW
WWWWWWWWWWWW
#ENDLEVEL 9

#LEVEL 10
WWWWWWWWWWWW
WRW R W OWRW
W   W O W OW
W R O   O RW
W   W W W OW
W R O R O RW
W O   W   OW
W R O R O RW
W O W O W OW
WRW O W RWRW
WWWWWWWWWWWW
#ENDLEVEL 10